0000000000000000000000000000000000000000000000000000000000000000000000000000000000000000000000000000000000000000000000000000000000000
0000000000000000000000000000000000000000000000000000000000000000000000000000000000000000000000000000000000000000000000000000000000000
0000000000000000000000000000000000000000000000000000000000000000000000000000000000000000000000000000000000000000000000000000000000000
0000000000000000000000000000000000000000000000000000000000000000000000000000000000000000000000000000000000000000000000000000000000000
0000000000000000000000000000000000000000000000000000000000000000000000000000000000000000000000000000000000000000000000000000000000000
0000000000000000000000000000000000000000000000000000000000000000000000000000000000000000000000000000000000000000000000000000000000000
0000000000000000000000000000000000000000000000000000000000000000000000000000000000000000000000000000000000000000000000000000000000000
0000000000000000000000000000000000000000000000000000000000000000000000000000000000000000000000000000000000000000000000000000000000000
0000000000000000000000000000000000000000000000000000000000000000000000000000000000000000000000000000000000000000000000000000000000000
0000000000000000000000000000000000000000000000000000000000000000000000000000000000000000000000000000000000000000000000000000000000000
0000000000000000000000000000000000000000000000000000000000000000000000000000000000000000000000000000000000000000000000000000000000000
0000000000000000000000000000000000000000000000000000000000000000000000000000000000000000000000000000000000000000000000000000000000000
0000000000000000000000000000000000000000000000000000000000000000000000000000000000000000000000000000000000000000000000000000000000000
0000000000000000000000000000000000000000000000000000000000000000000000000000000000000000000000000000000000000000000000000000000000000
0000000000000000000000000000000000000000000000000000000000000000000000000000000000000000000000000000000000000000000000000000000000000
0000000000000000000000000000000000000000000000000000000000000000000000000000000000000000000000000000000000000000000000000000000000000
0000000000000000000000000000000000000000000000000000011111110000000000000000000000000000000000000000000000000000000000000000000000000
1111110001111111111111111111111111111111111111110000122222221111111000000000000000000000000111111111111111111111111111111111111111111
2222220002222222222222222222222222222222222222221111222222222222222111111111111111111111111222222222222222222222222222222222222222222
2222220002222222222222222222222222222222222222222222222222222222222222222222222222222222222222222222222222222222222222222222222222222
2222220002222222222222222222222222222222222222222222222222222222223322222222222222222222222222222222222222222222222222222222222222222
2222220002222222222222222222222222222222222222222222222222222222222222222222222222222222222222222222222222222222222222222222222222222
2222220002222222222222222222222222222222222222222222222222222222222222222222222222222222222222222222222222222222222222222222222222222
3333330003333333333333333333333333333333333333333333333333333333333333333333333333333333333333333333333333333333333333333333333333333
3333330003333333333333333333333333333333333333333333333333333333333333333333333333333333333333333333333333333333333333333333333333333
3333330003333333333333333333333333333333333333333333333333333333333333333333333333333333333333333333333333333333333333333333333333333
3333330003333333333333333333333333333333333333333333333333333333333333333333333333333333333333333333333333333333333333333333333333333
3333330003333333333333333333333333333333333333333333333333333333333333333333333333333333333333333333333333333333333333333333333333333
3333330003333333333333333333333333333333333333333333333333333333333333333333333333333333333333333333333333333333333333333333333333333
3333330003333333333333333333333333333333333333333333333333333333333333333333333333333333333333333333333333333333333333333333333333333
3333330003333333333333333333333333333333333333333333333333333333333333333333333333333333333333333333333333333333333333333333333333333
3333330003333333333333333333333333333333333333333333333333333333333333333333333333333333333333333333333333333333333333333333333333333
